########    
#      #    
# ##$#$#### 
# @  $ $  # 
# $#   # $##
#    $   $ #
######.#.# #
     #.#.$ #
     #.#*#.#
     #...  #
     #######
