{
  "levels": {
    "1": {
      "level": [
        "########  ",
        "# ..#  #  ",
        "# ..# $###",
        "#  ##    #",
        "## $   $ #",
        " # ##  ###",
        " #   $##  ",
        " ###  #   ",
        "   #@ #   ",
        "   ####   "
      ]
    },
    "2": {
      "level": [
        " ####### ",
        "##     ##",
        "#  . $ @#",
        "# $*$$. #",
        "# $..$. #",
        "# $..$. #",
        "#########"
      ]
    },
    "3": {
      "level": [
        "#######",
        "# $.  #",
        "# *   #",
        "# *   #",
        "# *** #",
        "#   * #",
        "##  * #",
        " ## * #",
        "  # * #",
        "  ## @#",
        "   ####"
      ]
    },
    "4": {
      "level": [
        "#############",
        "#           #",
        "# ######.## #",
        "# # #   . # #",
        "# #   # $ # #",
        "# # ### ### #",
        "# # *   *  @#",
        "# #####$# ###",
        "#         #  ",
        "###########  "
      ]
    },
    "5": {
      "level": [
        "      ####    ",
        " ######  #    ",
        " #      $#####",
        " #.....  #   #",
        "### #### #$# #",
        "# $  @ $     #",
        "# $ ##########",
        "#   #         ",
        "#####         "
      ]
    },
    "6": {
      "level": [
        "#########",
        "#   #...#",
        "# $ @.*.#",
        "#  $#*..#",
        "# $ # $ #",
        "#  $#$  #",
        "# $ #   #",
        "#   #   #",
        "#########"
      ]
    }
  },
  "len": 6
}