########  
# ..#  #  
#   #  ###
#  ##    #
## $     #
 # ##  ###
 #   $##  
 ###  #   
   #@ #   
   ####   